"a" = (/obj/dummy{tag = "south"},/turf,/area)
"b" = (/obj/dummy{dir = 4; icon_state = "dummy_m"; tag = "icon-dummy (EAST)"},/turf,/area)
"c" = (/turf,/area)
"d" = (/obj/dummy{dir = 1; icon_state = "dummy_m"; tag = "icon-dummy (NORTH)"},/turf,/area)
"e" = (/obj/dummy{dir = 8; icon_state = "dummy_m"; tag = "icon-dummy (WEST)"},/turf,/area)

(1,1,1) = {"
abc
dec
"}
